1111111111111
10010CE0C01C1
1000C11110001
1P00110000001
1111111111111
