111111111111111111111111111111111111111111111
1P0000000000000000000000000000000000000000001
101111111011111110111111101111111011111110101
100000000000000000000000000000000000000000001
111101111101111111011111110111111101111101111
100001000000000000000000000000000000000100001
101111111011111110111111101111111011111110101
100000000000000000000000000000000000000000001
111101111101111111011111110111111101111101111
100001000000000000000000000000000000000100001
101111111011111110111111101111111011111110101
100000000000000000000000000000000000000000001
111101111101111111011111110111111101111101111
100001000000000000000000000000000000000100001
101111111011111110111111101111111011111110101
100000000000000000000000000000000000000000001
111101111101111111011111110111111101111101111
100001000000000000000000000000000000000100001
101111111011111110111111101111111011111110101
100000000000000000000000000000000000000000001
111101111101111111011111110111111101111101111
100001000000000000000000000000000000000100001
101111111011111110111111101111111011111110101
1C0000000000000000000000000000000000000000E01
111111111111111111111111111111111111111111111
