1111111111110
10010000001C1
1000011110001
1P00110000001
1111111111111
