111111111111111111111111111111111111111111111111111111111111
1P0000000000000000000000000000000000000000000000000000000001
101111111011111110111111101111111011111110111111101111111011
100000000000000000000000000000000000000000000000000000000001
111101111101111111011111110111111101111101111111011111101111
100001000000000000000000000000000000000100000000000000010001
101111111011111110111111101111111011111110111111101111111011
100000000000000000000000000000000000000000000000000000000001
111101111101111111011111110111111101111101111111011111101111
100001000000000000000000000000000000000100000000000000010001
101111111011111110111111101111111011111110111111101111111011
100000000000000000000000000000000000000000000000000000000001
111101111101111111011111110111111101111101111111011111101111
100001000000000000000000000000000000000100000000000000010001
101111111011111110111111101111111011111110111111101111111011
100000000000000000000000000000000000000000000000000000000001
111101111101111111011111110111111101111101111111011111101111
100001000000000000000000000000000000000100000000000000010001
101111111011111110111111101111111011111110111111101111111011
100000000000000000000000000000000000000000000000000000000001
111101111101111111011111110111111101111101111111011111101111
100001000000000000000000000000000000000100000000000000010001
101111111011111110111111101111111011111110111111101111111011
100000000000000000000000000000000000000000000000000000000001
111101111101111111011111110111111101111101111111011111101111
100001000000000000000000000000000000000100000000000000010001
101111111011111110111111101111111011111110111111101111111011
100000000000000000000000000000000000000000000000000000000001
111101111101111111011111110111111101111101111111011111101111
100001000000000000000000000000000000000100000000000000010001
101111111011111110111111101111111011111110111111101111111011
1C00000000000000000000000000000000000000000000000000000000E1
111111111111111111111111111111111111111111111111111111111111
111111111111111111111111111111111111111111111111111111111111
