1111111111111
1C01000000001
1E00011111111
1P000000C0C01
1111111111111
