1111111111111
1C01000000001
1E00011111111
1P00000000C01
1111111111111
